%s ago=il y a %s
%s used of %s %s %%=%s utilisé sur %s (%s %%)
1 m=1 m
10 s=10 s
2 m=2 m
30 s=30 s
5 m=5 m
Abort background operation=interrompre l'opération en arrière-plan
Abort background process=interrompre le processus en arrière-plan
Active tunnels=Tunnels actifs
Activity=Activité
ago=il y a
Airflow=Ventilation
Alert Message=Message d'alerte
Alerts=Alertes
All Apps=Toutes les Applis
All VMs=Toutes les VMs
Array Information=Information sur la baie
Attention - operation continues in background=Attention - l'opération continue en arrière-plan
Battery charge=Niveau de la batterie
BIOS dated=Date du BIOS
Check free space=Vérifier l'espace libre
Click to toggle CPU chart=Cliquez pour basculer le graphique CPU
Click to toggle details=Cliquer pour voir les détails
Clock is unsynchronized with no NTP servers=L'horloge n'est pas synchronisée avec aucun serveur NTP
Clock synchronized with %s NTP server=L'horloge est synchronisée avec %s serveur NTP
Clock synchronized with %s NTP servers=L'horloge est synchronisée avec %s serveurs NTP
Clone=Cloner
Close Tile=Fermer la tuile
Completed=Terminé(es)
Containers=Conteneurs
Content Management=Gestion du contenu
Counters info=Infos Compteurs
Current operation %s on %s=Opération en cours %s sur **%s**
custom image=Image personnalisée
Data is invalid=Données invalides
default image=Image par défaut
Docker Containers=Conteneurs Docker
Docker folder=Dossier Docker
Docker vdisk=Disque virtuel Docker
Due in=Prévu dans
Edit VM after clone=Modier la VM après le clonage
Elapsed time=Temps écoulé
Errors info=Informations sur les erreurs
Estimated finish=Estimation de fin
failed device=Disque défectueux
Fan count=Nombre de ventilateurs
Fan Information=Information sur les ventilateurs
FAN=VENTILATEURS
Finding %s error=**%s** erreur trouvée
Finding %s errors=**%s** erreurs trouvées
Flash device=Périphérique Flash
Free=Libre
General info=Infos Générales
Go to CPU pinning settings=Aller aux paramètres d'assignation de CPU
Go to date and time settings=Aller aux paramètres de date et heure
Go to disk settings=Aller aux paramètres des disques
Go to Docker settings=Aller aux paramètres Docker
Go to fan settings=Aller aux paramètres des Ventilateurs
Go to identification settings=Aller aux paramètres d'identification
Go to network settings=Accéder aux paramètres réseaux
Go to scheduler settings=Accéder aux paramètres du planificateur
Go to Share settings=Accéder aux paramètres de Partage
Go to UPS settings=Accédez aux paramètres de l'onduleur
Go to User settings=Accédez aux paramètres de l'utilisateur
Go to VM settings=Accéder aux paramètres de la machine virtuelle
Go to VPN settings=Accédez aux paramètres du VPN
Handshake=Négociations
has=a
healthy=Sain
heat warning=Avertissement de surchauffe
Hide details=Masquer les détails
in progress=En cours
Inactive tunnels=Tunnels inactifs
inactive=Inactif
Inbound=Entrant
Information=Information
Interface Information=Interface d'information
invalid device=Disque invalide
invalid devices=Disques invalides
Last check completed on %s=Dernière vérification effectuée le **%s**
Last check incomplete on %s=Dernière vérification incomplète le **%s**
Last checked on %s=Dernière vérification le **%s**
Legend=Légende
Lock sortable items=Vérouiller les éléments triables
Log filesystem=Jounalisation du système de fichiers
Maximum size=Taille Maximale
Memory Utilization=Utilization de la mémoire
Mode of operation=Mode de fonctionnement
Motherboard Information=Information sur la carte mère
Network traffic=Trafic réseau
New VM=Nouvelle VM
Next check scheduled on %s=Prochaine vérification prévue le **%s**
No docker containers defined=Aucun conteneur Docker défini
No running docker containers=Aucun conteneur Docker en cours d'exécution
No running virtual machines=Aucune machine virtuelle en cours d'exécution
No shares present=Aucun Partage présent
No virtual machines defined=Aucune Machine Virtuelle définie
Nominal power=Puissance nominale
not received=Non reçu
Notices=Notices
Notifications=Notifications
Only PNG images are allowed=Seules les images PNG sont autorisées
Outbound=Sortant
Output voltage=Tension de sortie
Overall Load=Charge générale
Overwrite=Réécriture
Parity disk not present=Disque de parité absent
Parity disks not present=Disques de parité absents
Parity has not been checked yet=La parité n'a pas encore été vérifiée
Parity Information=Information sur la parité
Parity is degraded=La parité est dégradée
Percent of total used memory=Pourcentage de la mémoire totale utilisée
Percent usage of Docker folder=Pourcentage d'utilisation du dossier Docker
Percent usage of Docker vdisk=Pourcentage d'utilisation du disque virtuel Docker
Percent usage of flash usb device=Pourcentage d'utilisation du périphérique USB flash
Percent usage of LOG file system=Pourcentage d'utilisation du système de fichiers LOG
Pool=Pool
Popup Blocked=Popup Blocked.
Power Status=État de l'alimentation
Power=Courant
Processor Information=Information sur le processeur
Put system to sleep=Mettre le système en veille
RAM usage=Utilisation de la RAM
Reboot the system=Redémarrer le système
Receive counters=Compteurs de réception
Received packets=paquets reçus
Runtime left=Temps d'exécution restant
Scheduled parity check is disabled=Le contrôle de parité programmé est désactivé
Select Case Model=Sélectionnez le modèle du boîtier
Select time frame=Sélectionner la période
Services=Services
Share count %s with %s cache only and %s encrypted=Nombre de partages: %s comprenant %s sur le cache uniquement et %s chiffrés
Shares Information=Informations sur les Partages
Show details=Afficher les détails
Show Information=Afficher les infos
Shutdown the system=Éteindre le système
SMART error=erreur SMART
SMART health-check failed=Échec du contrôle de santé SMART
SMART=SMART
sn=no.série
Snapshot Name=Nom du Snapshot
Snapshot=Snapshot
Start Cloned VM=Commencer la VM clonée
Start the array=Démarrer la baie
Started only=Démarré seulement
Stop the array=Arrêter la baie
Temp=Temp
This may leave an unknown state=Cela peut laisser un état inconnu
This will put the system to sleep=Cela mettra le système en veille
This will reboot the system=Cela va redémarrer le système
This will shutdown the system=Cela arrêtera le système
This will start the array=Cela va démarrer la baie
This will stop the array=Cela va arrêter la baie
Tile Management=Gestion des tuiles
Transmit counters=Compteur d'envoi
Transmitted packets=Paquets transmis
Unassigned Devices=Appareils non attribués
Unlock sortable items=Dévérouiller les éléments triables
UPS Load=Charge de l'onduleur
UPS Model=Modèle de l'onduleur
UPS status=État de l'onduleur
Usable size=Espace utilisable
User count %s with %s unprotected=Nombre d'utilisateurs: %s comprenant %s sans protection
Users Information=Information sur les utilisateurs
utilization warning=Avertissement d'utilisation
View Running Processes=Voir les processus en cours d'exécution
Virtual Machines=Machines Virtuelles
VM Being Cloned=VM en cours de clonage
VM Clone=Cloner la VM
VM Name=Nom de la VM
VPN Connections=Connexions VPN
W=Semaine
Warnings=Alertes
ZFS=ZFS

; Note: April 21, 2025 - 25 missing translations
checking=
Clock is synchronized using %s NTP servers, time offset is %s %s=
Clock is synchronized using %s PTP server, time offset is %s %s=
Clock is unsynchronized with no PTP servers=
Clock is unsynchronized, free-running clock=
device warning=
device warnings=
emulated=
FS Native Snapshot=
grandmaster=
heat warnings=
invalid=
master=
Memory dump=
No VMs running=
RX=
Share count %s with %s public SMB and %s public NFS=Share count: %s with %s public SMB and %s public NFS
ShowHide All Content=Show/Hide All Content
ShowHide Content=Show/Hide Content
SMART errors=
synching=
TX=
Unchecked will use QEMU External Snapshot=
utilization warnings=
Virtual Machines Usage=
