Access Mode=Mode d'accès
Add another Path, Port, Variable, Label or Device=Ajouter un autre chemin, port, variable, étiquette ou périphérique
Add Configuration=Ajouter une configuration
Add=Ajouter
Additional Requirements=Exigences supplémentaires
Always=Toujours
App to Host=Application à héberger
Application=Application
apply update=Appliquer la mise à jour
Are you sure=Êtes-vous sûr
Array must be Started to view Docker containers=La baie doit être démarré pour afficher les conteneurs Docker
Autostart=Démarrage automatique
Back=Retour
Backup=Sauvegarde
Beta=Beta
Books=Livre
By=Par
Categories=Catégories
Check for Updates=Vérifer les mises à jour
Cloud=Cloud
Config Type=Type de config
Configuration not found=Configuration introuvable
Connection Type=Type de connexion
Console shell command=Terminal de commande
Container ID=ID du Conteneur
Container Path=Chemin du conteneur
Container Port=Port du conteneur
Container Size=Taille du conteneur
Container=Conteneur
CPU Memory load=Charge mémoire CPU
CPU Pinning=Assignation CPU
Created=Créé
Crypto Currency=Crypto Monnaie
Default Value=Valeur par défaut
Device=Périphérique
Display=Affichage
DNS=DNS
Docker Containers=Conteneurs Docker
Docker Hub URL=URL du Hub Docker
Docker Service failed to start=Le service Docker n'a pas pu démarrer
Downloaders=Téléchargeurs
Drivers=Pilotes
Edit Configuration=Modifier la configuration
Exited=Sortir
Extra Parameters=Paramètres supplémentaires
Fixed IP address=Adresse IP fixe
force update=Forcer la mise à jour
FTP=FTP
Game Servers=Serveur de jeu
healthy=Sain
Hide Buttons=Masquer les boutons
Hide docker allocations=Masquer les allocations Docker
Hide more settings=Masquer les paramètres supplémentaires
Home Automation=Domotique
Host Path=Chemin de l'hôte
Host Port=Port de l'hôte
HT=HT
Icon URL=URL de l'icône
Image ID=ID de l'image
Key=Clé
Label=Étiquette
Lock sortable items=Verrouiler les objets à trier
Management=Administration
MediaApp=Application multimédia
MediaServer=Serveur multimédia
Messenger=Messenger
Missing parameters=Paramètres manquants
Music=Musique
Network Type=Type de Réseau
No Docker containers installed=Aucun conteneur Docker installé
None Listed=Aucun listé
of=de
orphan image=Image orpheline
Other=Autre
Overview=Aperçu
Path=Chemin d'accès
Pause All=Tout mettre en pause
Photos=Photos
Port Mappings=Mappages de ports
Port=Port
Post Arguments=Post-argumentation
Privileged=Privilégié
Productivity=Productivité
Project Page=Page du Projet
Proxy=Proxy
Pulling image=Récupération de l'image
Read Me First=Lisez-moi d'abord
Read Only - Shared=Lecture seule - Partagé
Read Only - Slave=Lecture seule - Esclave
Read Only=Lecture seule
ReadWrite - Shared=Lecture/Écriture - Partagé
ReadWrite - Slave=Lecture/Écriture - Esclave
rebuild ready=Reconstruction Prête
rebuilding=Reconstruction en cours
Remove template=Supprimer le modèle
Removing container=Retrait du conteneur
Removing orphan image=Suppression d'une image orpheline
Repository=Référentiel
Required=Requis
Reset sorting=Réinitialiser le tri
Resume All=Tout reprendre
Save=Sauvegarder
Select a template=Sélectionner un modèle
Select categories=Sélectionner les catégories
Show docker allocations=Afficher les allocations de docker
Show more settings=Afficher les paramètres supplémentaires
Stable=Stable
Start All=Tout Démarrer
starting up containers=Démarrage des conteneurs
Stop All=Tout arrêter
Stopping container=Arrêt du conteneur en cours
Successfully removed container=Conteneur supprimé avec succès
Successfully removed orphan image=Image orpheline supprimée avec succès
Successfully stopped container=Conteneur arrêté avec succès
Support Thread=Fil de support
Template URL=URL du modèle
Template=Modèle
The command failed=La commande a échoué
The command finished successfully=La commande s'est terminée avec succès
TOTAL DATA PULLED=NOMBRE DE DONNÉES RECUPEREES
Total size=Taille totale
Unknown action=Action inconnue
Unlock sortable items=Déverrouiller les objets à trier
Update All=Tout Mettre à jour
update ready=La mise à jour est prête
Value=Valeur
Variable=Variable
Video=Vidéo
Voip=VoIP
Volume Mappings=Mappages des volumes
wait=Attendre
Was this container created using this plugin=Ce conteneur a-t-il été créé à l'aide de ce plugin
Web=Web
WebUI=Interface Web
Writable=Accessible en écriture
