%s An update is available=%s: Une mise à jour est disponible
Alert Message=Message d'alerte
anonymous=anonyme
Author=Auteur
Check For Updates=Vérifier les mises à jour
Checking connectivity=Vérification de la connectivité
checking=vérification
Click here to install version %s=Cliquer ici pour installer la version %s
Delete Plugin=Supprimer le plugin
DOWNGRADE TO VERSION=RÉTROGRADER À LA VERSION
Enter URL of remote plugin file or local plugin file=Entrer l'URL d'un fichier de plugin local ou distant
ERROR=ERREUR
I have read the release notes=J'ai lu la note de version
Install Plugin=Installer un Plugin
Install=Installer
install=installer
Installed Plugins=Plugins installés
Installing Update=Installation d'une mise à jour
need check=vérification nécessaire
Next=Suivant
No plugins installed=Pas de plugins installés
No release notes available=Aucune note de version disponible
No response, aborting=Pas de réponse, abandon
Plugin File Install Errors=Erreurs d'installation du fichier du plug-in
Plugin File=Fichier de Plugin
Plugin History=Historique plugins
Plugin Update Check=Vérifier mise à jour de plugin
Plugin=Plugin
Release Notes=Notes de version
Remove Plugin=Retirer le plugin
Remove Selected Plugins=Supprimer les plugins sélectionnés
remove=supprimer
Select local plugin file=Sélectionner un fichier de plugin local
Stable=Stable
STALE=PÉRIMÉ
Support Thread=Fil de Support
Uninstall=Désinstaller
Update All Plugins=Mettre à jour tous les plugins
Update Incompatible=Mise à jour incompatible
Update Plugin=Mettre à jour le plug in
Upgrade=Mettre à niveau
View Release Notes=Voir les notes de version

; Note: April 21, 2025 - 1 missing translations
cannot check=
