Cancel=Annuler

; My PSAs / banners
Happy New Year=Bonne Année
Happy Holidays from Andrew, Tracey, and family=Joyeuses Fêtes de la part de Andrew, Tracey, et toute la famille
Please Enjoy Responsibly=S'il vous plaît utiliser de manière responsable
Popup Blocked CA requires popups to be enabled under certain circumstances You must white list your server within your browser to allow popups=Popup Bloqué. CA nécessite que les popups soient activés dans certaines circonstances Vous devez lister votre serveur dans votre navigateur pour autoriser les popups
Docker Service Not Enabled - Only Plugins Available To Be Installed Or Managed=Service Docker Non-Activé - Seuls les plugins disponibles peuvent être installés ou gérés
Docker system failed to start - Only Plugins Available To Be Installed Or Managed=Le système Docker n'a pas démarré - Seuls les plugins disponibles pour être installés ou gérés
Array not started - Only Plugins Available To Be Installed Or Managed=La baie n'est pas démarrée - Seuls les Plugins sont disponibles pour être installés ou gérés
Community Applications works best when cookies are enabled in your browser Certain features may not be available=Les Applications Communautaires fonctionnent mieux lorsque les fichiers témoins (cookies) sont activés dans votre navigateur Certaines fonctionnalités peuvent ne pas être disponibles
Backup Server Active Some icons may not appear, and plugin installations may be affected=Serveur de sauvegarde actif Certains icônes peuvent ne pas apparaître et les installations de plug-ins peuvent être affectées
Debugging enabled This significantly increases the memory used by your browser=Débogage activé cela augmente considérablement la mémoire utilisée par votre navigateur
Browser translation detected Display issues may result=Traduction par navigateur détectée Des problèmes d'affichage peuvent survenir
Action Centre Enabled=Centre d'action activé
Deprecated OS version No further updates to Community Applications will be issued for this OS version=Version du système d'exploitation obsolète. Aucune autre mise à jour des applications communautaires ne sera publiée pour cette version du système d'exploitation.

; Sorting Options
Sort By=Trier par
Name Ascending=Nom croissant
Name Descending=Nom Décroissant
Downloads=Télécharger
Date Added=Date d'ajout
Number Of Apps=Nombre d'applications
; Initial disclaimer translations
Disclaimer=Désistement
All applications listed here are 3rd party additions to Unraid Neither the authors of Community Applications nor Limetech make any warranty as to the suitability of any application listed here=Toutes les applications répertoriées ici sont des ajouts de tierce-partie à unRaid. Ni les auteurs des applications communautaires ni Limetech ne donnent de garantie quant à la validité de toute application répertoriée ici.
Every attempt is made to ensure that only safe and compatible applications are present=Tous les efforts sont faits pour s'assurer que seules des applications sûres et compatibles sont présentes
Application Policy=Politique d'Application
I Understand=Je Comprends
Installations of apps disabled You must accept the warning to be able to install applications=Installations d'applications désactivées Vous devez accepter l'avertissement pour pouvoir installer des applications
Click here=Cliquez ici
%s Results Per Page=%s Résultats par page
Results Per Page: %s=Résultats par page : %s

; Plugin Disclaimer
Community Applications contains both docker containers and plugin applications Plugins are designed for OS enhancements, and run with full privileges on your system and are clearly identified within CA=Les applications de communauté contiennent à la fois des conteneurs de docker et des applications de plugin. Les plugins sont conçus pour des améliorations du système d'exploitation, et s'exécutent avec des privilèges complets sur votre système et sont clairement identifiés dans CA
Plugin Note=Note du Plugin

; Multi Install
Install Plugin Applications=Installer les Application de Plugins
Select all on page=Sélectionner tout sur la page
Install Application=Installer l'application
Install Applications=Installer les applications
Update Application=Mise à jour de l'application
Update Applications=Mise à jour des applications
Are you sure you want to update %s applications=Etes-vous sûr de vouloir mettre à jour %s applications
Are you sure you want to install %s docker and %s plugin applications=Êtes-vous sûr de vouloir installer %1$s docker et %2$s plugins ?

; Searches
Search=Recherche
Click Here To Get More Results From DockerHub=Cliquer ici pour obtenir plus de résultats de Docker Hub
No Matching Applications Found=Aucune application correspondante trouvée

; Repository Related
%s removed as favourite repository=%s supprimé comme dépôt favori
%s set as favourite repository=%s définir comme référentiel favori
Click to remove favourite repository=Cliquer pour supprimer le référentiel favori
Click to set %s as favourite repository=Cliquer pour définir %s comme référentiel favori
Search for apps in repository=Rechercher des applications dans le référentiel
No description present=Aucune description présente
Go to the forum page=Allez sur la page du forum
Go to the webpage=Aller à la page Web
Go to reddit=Aller sur reddit
Go to facebook=Aller sur facebook
Go to discord=Aller sur discord
Go to forum profile=Aller au profil du forum
Show Profile=Afficher profil
SHOW MORE=AFFICHER PLUS
SHOW LESS=AFFICHER MOINS
Read more=En savoir plus
Total Applications=Total Applications
Total Known Downloads=Total des téléchargements connus
Total Docker Applications=Total Docker Applications
Total Plugin Applications=Total Plugin Applications
Total Languages=Langues totales
Average Downloads Per App=Téléchargements moyens par application
Web Page=Page Web
Forum=Forum
Forum Profile=Profil du forum
Profile=Profil
Facebook=Facebook
Reddit=Reddit
Twitter=Twitter
Discord=Discord
Search Apps=Rechercher des applications
Registry=Registre
Details=Détails
Added=Ajouté
; Install Plugin title of openbox
Install Plugin=Installer Plugin
Update Plugin=Mettre à jour le plugin

Requirements not met=Configuration requise non respectée
The requirements for this upgrade have not been met on your system=Les conditions requises pour cette mise à jour n'ont pas été remplies sur votre système
The sidebar for the app click info will list the details=La barre latérale de l'application (cliquez sur info) affichera les détails

BACK=RETOUR

; Remove App from previously installed
Delete Template=Supprimer le Modèle
Yes, delete it=Oui, la supprimer

; Uninstall popup
Uninstall Application=Désinstaller l'Application
Yes uninstall it=Oui la désinstaller

; Remove Private Application
Remove Private Application=Retirer l'Application Privée
Yes, remove it=Oui, la retirer

; App Pinning
Click to pin this application=Cliquez pour épingler cette application
Click to unpin this application=Cliquez pour désépingler cette application
Pin App=Attacher l'app
Unpin App=Détacher l'app

; Branch installations
Choose A Branch To Install=Choisir la Branche a Installer

; Multiple application installs
; no apps selected
Install Selected Applications=Installer les Applications Épinglées

Yes, install it=Oui, l'installer

; Multi-install popup
Yes, install them=Oui, les installer
Cookies not enabled Plugins must be separately installed from docker applications=Fichiers Témoins (Cookies) non activés. Les Plugins doivent être installés séparément des applications docker
Docker applications will be installed utilizing the most recently saved template with no user input on your part=Les applications Docker seront installées en utilisant le modèle le plus récemment sauvegardé, sans aucune intervention de votre part
Updating Support Links=Mise à jour des liens de support
Downloading docker icons=Téléchargement des icônes Docker
Finished Installing If the DONE button did not appear, then you will need to click the red X in the top right corner=Installation Terminée. Si le bouton TERMINÉ n'apparaît pas, vous devez cliquer sur le X rouge dans le coin supérieur droit

; error messages
An error occurred Could not find any %s Apps=Une erreur s'est produite. Impossible de trouver aucune Application de %s
Download of appfeed failed=Le téléchargement de l'appfeed a échoué
; the %s here refers to a function being called
Something really went wrong here=Quelque chose s'est vraiment mal passé ici
Post the ENTIRE contents of this message in the Community Applications Support Thread=Soumettre le contenu ENTIER de ce message dans le fil de discussion du soutien aux applications communautaires
Unknown error happened Please post a screenshot in the support thread of the Statistics screen=Une erreur inconnue s'est produite. Veuillez poster une capture d'écran dans le fil de soutien de la page de Statistiques
This plugin has a duplicated name from another plugin %s This will impact your ability to install both plugins simultaneously=Ce plugin a un nom dupliqué d'un autre plugin %s Cela aura un impact sur votre capacité à installer les deux plugins simultanément
You have been logged out=Vous avez été déconnecté
Fatal Flash Drive Error=Erreur fatale du lecteur flash
This usually means your flash drive is corrupted or has dropped offline The rest of the Unraid GUI will also be affected Post a new thread in the Unraid forums if this error continues=Cela signifie généralement que votre clé USB est corrompue ou est tombée hors ligne Le reste de l'interface graphique Unraid sera également affecté Publiez un nouveau fil de discussion dans les forums Unraid si cette erreur persiste
Fatal Docker Image Error=Erreur fatale d'image Docker
Your docker image or folder is either read-only or completely full Issues will result because of this You should create a new post in the Unraid forums and include your diagnostics=Votre image ou dossier docker est soit en lecture seule, soit complètement plein. Des problèmes en résulteront. Vous devez créer un nouveau message dans les forums Unraid et inclure vos diagnostics
This template is set up to use a custom network You may have to adjust the network or IP address etc to match your system=Ce modèle est configuré pour utiliser un réseau personnalisé. Vous devrez peut-être ajuster le réseau ou l'adresse IP, etc. pour correspondre à votre système
This template is set up to run as Privileged This is a possible security risk and usually does not need to be enabled Note that some applications require privileged in order to operate correctly=Ce modèle est configuré pour fonctionner en mode Privilégié. Il s'agit d'un risque de sécurité potentiel et il n'est généralement pas nécessaire de l'activer. Notez que certaines applications requièrent des privilèges pour fonctionner correctement
One or more ports used by this application are already in use by another service or app running on your server You will need to adjust the host ports accordingly on the template=Un ou plusieurs ports utilisés par cette application sont déjà utilisés par un autre service ou une autre application fonctionnant sur votre serveur. Vous devrez ajuster les ports hôtes en conséquence sur le modèle
Not Enough Memory=Pas assez de mémoire
Community Applications and Unraid OS have a minimum required installed memory of 4G CA cannot run without those mimimums being met=Les applications communautaires (CA) et le système d'exploitation Unraid nécessitent un minimum de 4Go de mémoire installée. Community Applications ne peut pas fonctionner si ce minimum n'est pas respecté
Run Anyways=Exécuter malgré tout
Memory Requirements not met Problems may result=Mémoire requise non respectée. Des problèmes peuvent survenir
Installation already in progress=L'installation est déjà en cours
Another plugin installation or update is already in progress and this one cannot start Wait until the current installation or update is completed and try again=L'installation ou la mise à jour d'un autre plugin est déjà en cours et celle-ci ne peut pas démarrer. Attendez que l'installation ou la mise à jour en cours soit terminée et réessayez
%s is incompatible with your OS version Please update the OS to proceed=%s est incompatible avec la version de votre système d'exploitation. Veuillez mettre à jour le système d'exploitation pour continuer
%s is incompatible with your OS version Either uninstall %s or update the OS=%s est incompatible avec la version de votre système d'exploitation. Désinstallez %s ou mettez à jour le système d'exploitation
Browser failed to communicate with Unraid Server=Le navigateur n'a pas réussi à communiquer avec le serveur Unraid
For unknown reasons, your browser was unable to communicate with Community Applications running on your server=Pour des raisons inconnues, votre navigateur n'a pas pu communiquer avec Community Applications fonctionnant sur votre serveur
Attempt to Fix Via Reload Page=Tentative de correction en rechargant la page

; CA Sections Keep the length reasonable
Home=Accueil
Installed Apps=Applications Installées
Previous Apps=Applications Précédentes
Pinned Apps=Applications Épinglées
Favourite Repo=Dépôt favori
Action Centre=Centre des actions
Recently Added=Récemment ajouté
Random Apps=Apps aléatoires
Top New Installs=Top des nouvelles installations
Top Trending Apps=Apps les plus populaires
Spotlight Apps=Apps en vedette
All Apps=Toutes les Apps
Statistics=Statistiques
Credits=Crédits
Support=Support
VERSION=VERSION
Change Log=Journal des modifications
Debugging=Débogage

; Credits
Development=Développement
Additional Contributions=Contributions Supplémentaires
GUI Layout Design=Conception De L'interface Graphique
Application Feed=Feed d'Applications
Additional Testing=Tests Supplémentaires
Moderation=Modération
Additional Libraries=Librairies Supplémentaires
Copyright=Droits D'Auteur
Translation=Traduction

; Statistics page

unknown=inconnu
Last Change To Application Feed=Dernier Changement au Feed d'Applications
Docker Applications=Applications Docker
Plugin Applications=Applications Plugin
Templates=Modèles
Official Containers=Containers officiel(s)
Repositories=Dépôts
Private Docker Applications=Application Docker Privées
Invalid Templates=Modèles Invalides
Template Errors=Erreurs de Modèles
Blacklisted Apps=Applications sur la liste noire
Incompatible Applications=Applications Incompatibles
Deprecated Applications=Applications obsolètes
Moderation Entries=Entrées de Modération
Primary Server=Serveur Primaire
Backup Server=Serveur de Sauvegarde
Installs not allowed from this page=Installations non autorisées à partir de cette page

; Statistics Popup
No invalid templates found=Aucun modèle invalide trouvé
These templates are invalid and the application they are referring to is unknown=Ces modèles ne sont pas valides et l'application à laquelle ils font référence est inconnue
No templates were automatically fixed=Aucun modèle n'a été automatiquement réparé
All of these errors found have been fixed automatically=Toutes ces erreurs trouvées ont été automatiquement réparées
Note that many of these errors can be avoided by following the directions=Notez que plusieurs de ces erreurs peuvent être évitées en suivant les instructions
HERE=ICI
The following plugins have duplicated filenames and are not able to be installed simultaneously=Les plugins suivants ont des noms de fichiers dupliqués et ne peuvent pas être installés simultanément
The following docker applications refer to the same docker repository but may have subtle changes in the template to warrant this=Les Applications docker suivantes se réfèrent au même dépôt de docker mais peuvent avoir des changements subtils dans le modèle pour justifier ceci
If any of these entries are incorrect then contact the moderators of CA to discuss=Si l'une de ces entrées est incorrecte, contactez les modérateurs du CA pour discuter
Global Repository Comments=Commentaires Globaux sur le Dépot
Applied to all applications=(Appliqué à toutes les Applications)
Individual Application Moderation=Modération Individuelle des Applications

; Misc
Community Applications Changelog=Changelog des Applications Communautaires

Each month we highlight some of the amazing work from our community=Chaque mois, nous mettons en évidence certains des travaux incroyables de notre communauté
Check out these newly added applications from our awesome community=Découvrer ces applications nouvellement ajoutées de notre communauté géniale
Check out these up and coming apps=Découvrer ces apps à venir
These apps have the highest percentage of new installs=Ces apps ont le pourcentage le plus élevé de nouvelles installations
An assortment of randomly chosen apps=Un assortiment d'apps choisies au hasard
Featured Applications=Applications en vedette

; Categories try not to be excessively long This is displayed on the left of CA screen

Backup=Sauvegarde
Cloud=Cloud
Crypto Currency=Crypto Monnaie
Downloaders=Téléchargeurs
Drivers=Pilotes
Game Servers=Serveurs de Jeux
Home Automation=Domotique
Media Applications=Applications Media
Books=Livres
Music=Musique
Photos=Photos
Video=Video
Other=Autre
Media Servers=Serveurs Media
Network Services=Services Réseau
DNS=DNS
FTP=FTP
Management=Gestion
Messenger=Messenger
Proxy=Serveur Proxy
VOIP=VOIP
VPN=VPN
Web=Web
Privacy=Vie privée
Productivity=Productivité
Security=Sécurité
Spotlight=En vedette
Tools Utilities=Outils / Utilitaires
System=Système
Themes=Thêmes
Utilities=Utilitaires
Private Apps=Applications Privées
Uncategorized=Non-Catégorisé

; Categories displayed within a popup or on the card.  Where an entry exists after the "=" it is not translated, but rather how it should look
GameServers=Serveurs de Jeux
HomeAutomation=Domotique
MediaApp=Appli Média
MediaAppBooks=Appli Média:Livres
MediaAppMusic=Appli Média:Musique
MediaAppPhotos=Appli Média:Photos
MediaAppVideo=Appli Média:Vidéo
MediaAppOther=Appli Média:Autre
MediaServer=Serveur:Media
MediaServerBooks=Serveur Média:Livres
MediaServerMusic=Serveur Média:Musique
MediaServerPhotos=Serveur Média:Photos
MediaServerVideo=Serveur Média:Vidéo
MediaServerOther=Serveur Média:Autre
Network=Réseau
NetworkDNS=Réseau:DNS
NetworkFTP=Réseau:FTP
NetworkManagement=Réseau:Gestion
NetworkProxy=Réseau:Proxy
NetworkVOIP=Réseau:VOIP
NetworkVPN=Réseau:VPN
NetworkPrivacy=Network:Privacy
NetworkWeb=Réseau:Web
NetworkOther=Réseau:Autre
ToolsSystem=Outils:Système
ToolsThemes=Outils:Thêmes
ToolsUtilities=Outils:Utilitaires
OtherUncategorized=Autres:Non-catégorisé
and %s more=et %s de plus

; App Popup Related
This application template has been blacklisted=Ce modèle d'Apps a été mis sur liste noire
This application template has been deprecated=Ce modèle d'application est obsolète
This application has additional requirements=Cette application a des exigences supplémentaires
Additional Requirements=Exigences supplémentaires
Donate To Author=Faire un Don à l'Auteur
Donate To Maintainer=Faire un Don au Mainteneur
CLOSE=FERMER
Author=Auteur
Maintainer=Responsable
DockerHub=DockerHub
Application Template=Modèle d'Application
DockerHub Stars=Étoiles DockerHub
Added to CA=Ajouté au CA
Date Updated=Date de mise-à-jour
Current Version=Version Actuelle
Min OS=SE Minimal
Max OS=SE Maximum
Total Downloads=Total de Téléchargements
Popularity=Popularité
Licence=Licence
Ranked #%s=Coté #%s
; as in Trending up or down arrow
Trending %s=Tendance %s
; as in As of some date
As of %s=(Depuis %s)
Play Video=Lire la vidéo
Play Video %s=Lire la vidéo %s
This application is not compatible with your version of Unraid=Cette application n'est pas compatible avec votre version d'Unraid
Another browser tab or device has updated the displayed templates Some actions are not available=Un autre onglet ou navigateur a mis à jour les modèles affichés Certaines actions ne sont pas disponibles
WebUI=WebUI
Reinstall=Réinstaller
Reinstall From Previous Apps=Réinstaller à partir des applications précédentes
Install=Installer
Uninstall=Désinstaller
Project=Projet
Read Me First=Lisez-moi d'abord
Install Using The Templates Default Tag=Installer à l'aide de la balise par défaut des modèles
Moderator Comments=Commentaires du Modérateur :
Note not all authors keep up to date on change logs=Notez que tous les auteurs ne sont pas à jour sur les journaux de modifications
Note not all maintainers keep up to date on change logs=Notez que tous les mainteneurs ne sont pas à jour sur les journaux de modifications
Last Update=Dernière mise à jour
Note All statistics are only gathered every 30 days=Note: Toutes les statistiques ne sont collectées que tous les 30 jours
;the following if using a space you MUST use nbsp but keep it down to one word if at all possible
Donate=Dons
Currently Installed Version=Version Installée
Install The Update=Installer la Mise-à-jour
; as in you have the latest version already installed
Latest Version=Dernière Version
Multi Language Support=Prise en charge Multilingue
Support Forum=Forum de support
; as in more than 100000
More than %s=Plus de %s
Remove from Previous Apps=Supprimer des Apps précédentes
Remove=Supprimer
See All Apps=Voir toutes les Apps
Favourite=Favori
Application Type=Type d'application

; Graphs
Trend Per Month=Tendance Par Mois
Downloads Per Month=Téléchargements Par Mois

; Multi install script
Installing docker applications %s=Installation des dockers %s
Starting %s=Démarrage de %s
%s failed to start You should install it by itself to fix the errors=Le démarrage de %s a échoué Vous devriez l'installer seul pour corriger les erreurs
Setting installed applications to autostart=Configuration des applications installées pour démarrage automatique
Docker Application Installation finished=Installation de l'Application Docker terminée

; Application Cards
Actions=Actions
Pending=En attente
This application is a driver plugin=Cette application est un pilote (plugin)
This is a language pack=Ceci est un pack de langue
This application is a docker container=Cette application est un conteneur docker
This application is a plugin=Cette application est un plugin
This is a spotlight application=Cette application est une application mise en avant
This is your favourite repository=Ceci est votre dépôt préféré
This application is from your favourite repository=Cette application provient de votre dépôt préféré
This application is pinned for later viewing=Cette application est épinglée pour une visualisation ultérieure
Private Application=Application privée
Remove Application From List=Retirer l'Application de la liste
Check off to select multiple reinstalls=Décocher pour sélectionner des réinstallations multiples
Go to the plugin settings=Aller aux paramètres du plugin
Click to reinstall the application using default values=Cliquez pour réinstaller l'application avec les valeurs par défaut
Click to edit the application values=Cliquez pour modifier les valeurs de l'application
Click to reinstall=Cliquez pour réinstaller
Click to install=Cliquez pour installer
Click to go to the WebUI=Cliquez pour aller à l'interface Web
This application template has been deprecated=Ce modèle d'application est obsolète
This application template has been blacklisted=Ce modèle d'Apps a été mis sur liste noire
Click info to see the notes regarding this application=Cliquez sur info pour voir les notes concernant cette application
This application has additional requirements=Cette application a des exigences supplémentaires
BETA=BETA
INSTALLED=INSTALLÉ
OFFICIAL=OFFICIEL
UPDATED=MISE À JOUR
This is an official container=Ceci est un conteneur officiel
Digitally Signed=Signé numériquement
This container is digitally signed=Ce conteneur est signé numériquement
Docker Hub=Docker Hub
NOTE You must visit the dockerHub page to gather the information required to install correctly=NOTE Vous devez visiter la page dockerHub pour rassembler les informations nécessaires à une installation correcte
Show CA templates=Afficher les modèles CA
Deprecated=Déprécié
Incompatible=Incompatible
Blacklisted=Sur liste noire
Template Exists=Le modèle existe
Template already exists in Apps=Le modèle existe déjà dans Apps
; eg: LinuxServer Repository
%s Repository=Dépôt de %s
; eg: Squid's Repository
%s's Repository=Dépôt de %s

Info=Info
Attention=Attention
Repository=Dépôt
Why we picked it=Pourquoi nous l'avons choisi
Application Spotlight %s=Applications en vedette %s=
Unraid Staff=Équipe Unraid

; Page Navigation
Displaying %s - %s of %s=Affichage %1$s - %2$s (de %3$s)

Updating Content=Mise-à-jour du contenu
Language=Langue
Switch to this language=Passer à cette langue
Country Code=Code de Pays
Install Language Pack=Installer le Module Linguistique
Remove Language Pack=Désinstaller le Module Linguistique
Update Language Pack=Mettre a jour le Module Linguistique
Installed Version=Version Installée
A note about translations=A propos des traductions
Click here to view the language changelog=Cliquer ici pour voir le changelog de la langue
View Missing Translations=Afficher les traductions manquantes

; Update Checks
Check For Updates=Vérifier les mises à jour
Check for updates already running=Vérifier les mises à jour déjà en cours
Checking for docker container updates=Vérifier les mises à jour des containeurs Docker
Checking for plugin updates=Vérifier les mises à jour des plugins
Checking for language updates=Vérifier les mises à jour des langues
Checking %s=Vérification de %s

; dockerHub conversions
Determine configuration=Déterminer la configuration
Would you like CA to attempt to determine any applicable paths, ports, and variables for the template This will entail performing a test installation of the container It will be automatically deleted after processing The container will not be started=Souhaitez-vous que CA tente de déterminer les chemins d'accès, les ports et les variables applicables au modèle ? Cela impliquera une installation de test du conteneur Il sera automatiquement supprimé après traitement Le conteneur ne sera pas démarré.
An error occurred - Could not determine configuration=Une erreur s'est produite - Impossible de déterminer la configuration
; WebGui
Click Install to download and install the Community Applications plugin=Cliquez sur **Install** pour télécharger et installer le **Community Applications** plugin


; Note: April 21, 2025 - 5 missing translations
Clear Flag=
Additional information may be within Tools, PHPSettings - View Log=
External Link=
Clicking OK will take you to a 3rd party website not associated with Limetech=
Install another instance=
